█████████████████4███████████████████
█$$     X    $$██ ██$$    X       $$█
█$     █ █    $██ ██$    █ █       $█
█      █ █     ██ ██     █ █        █
█      █ █     ██ ██     █ █        █
████████ ████████ ████████ ██████████
█                                   █
████████ █████████████████ ██████████
█      █ █   X $$█$$  X  █ █        █
█  X   █ █    X $█$  X   █ █     X  █
█$  X  █ █     X █  X    █ █    X  $█
█$$  X           █             X  $$█
█████████████████████████████████████
