█████████████████4███████████████████
█              ██ ██                █
█              ██ ██                █
█              ██ ██                █
█              ██ ██                █
█        ████████ ████████          █
█                                   █
█                                   █
█                                   █
█                                   █
█                                   █
█                                   █
█████████████████████████████████████
